X X X X X X X X X X
X C X E - - D - - X
X - X - X X X X - X
X - X - X K X - - X
X - X - X - X - X X
X G - - - - - P X
X L X X X X X X X
X X X